EA textures/east_wall.xpm
F 0,50,0
WE textures/west_wall.xpm
SO textures/south_wall.xpm
C  173,216,230
NO textures/north_wall.xpm
     1111111111111111111111111
     1000000000110000000000001
     1011000001110000000000001
     100100000000000000000000111111111
111111111011000001110000000000001
10000000001100000111111111111111
1111111111111011100000010001
1111011111111101101010010001
11000000110101011100000010001
10000000000000001100000000001
10000000000000001101010010001
11000001110101011111011110N111
11110111 1110101 101111010001
11111111 1111111 111111111111
