EA textures/east_wall.xpm
F 0,255,0
WE textures/west_wall.xpm
SO textures/south_wall.xpm
C 113,21,11    
NO textures/north_wall.xpm
111   111111111111111111111111
101   1000000000110000000000001
111   1011000001110000000000011
     100100000000000100000000111111111
111111111011000000012000000000001
100000000011000001112111111111111
11110111111111011100111010001
111101111110110101001 101111
11000111110101011100111010001
10000000000000000000000000001
1000000000000000110101001N001
110000011101010111110111100001
11110111 1110101 101111010001
11111111 1111111 11111111111
1