EA   textures/east_wall.xpm
F  0,255,0
WE   textures/west_wall.xpm
SO  textures/south_wall.xpm
C    173,21,1
NO textures/north_wall.xpm
     1111111111111111111111111
     1000000000110000000000001
     1011000001110000000000001
     100100000000000000000000111111111
111111111011000001110000000000001
100000000011000001112111111111111
11110111111111011100000010001
1111011111101101010010001111
11000111110101011100000010001
10000000000000000000000000001
1000000000000000110101001N001
110000011101010111110111100001
11110111 1110101 101111010001
11111111 1111111 11111111111
1